###############################################################
#     #     %%%%       ^ $  #$ #                             $#
#     #                ^    #  #                        #######
#  $% #                     #  #                        #     #
#     #####   ###############  #         ################  %  #
####           % $          #  ######         #         #  %  #
#$$#   #############        #                 #         #  %  #
#^ #        #               #########         #         #  %  #
#  #####    #                                 #         #  %  #
#           #        ^^^^% %                  #         #     #
#########   #        ^^^^ %                   #         #     #
#    #      #                                           #     #
#    #      #       #####################################     #
#    #      #                                 ^^^     $       #
#                                                             #
###############################################################